9 18
##    ######     #
   #  ###### ## ##
#####    ###     #
########     #####
##       ###  ####
##### ####     ###
#####   #   ## ###
#       #####   ##
####### ####### ##